333    333
1122222211
2222222222
1  3  3  1
1113113111
2  3  3  2